****************
*K             *
*              *
*              *
*             C*
****************