****************
*K   *  **   ***
*     E        *
***            *
*  E*  **  E   *
*   *          *
*** * **  *  *C*
****************
