*****
*K* *
*  **
* *E*
*****
