****************
*K  **  **   ***
* * * * ** * * *
* *  **    *   *
* * *   ** *** *
*     * **   * *
*  ** *  * * *E*
****************
