**********************************
*K    **** *** E ** **    **   ***
*  *  *E *  **      ** *** * * E *
****  *          *       * *     *
*        ******   ******   *     *
*****   ******     E  ** **  *   *
**     E   **   *  *  *   ** **  *
*    ****        *  *  ***   *** *
*  E ****  **  E  *  **  **      *
*      *      **** *  *  **      *
***** **  *  ********           C*
**********************************